#############################
#.......#.......#......##...#
#..#....#...................#
#..#....#..##......#........#
####@...#...#.########..#...#
##.....##...#...........###.#
#...#.......#..######...#...#
#...######.##.......#.......#
#...........#...............#
#############################
25
