##########################################################
#..............#.........................................#
#..............#.........................................#
#...#....................................................#
#...#............................##############..........#
#...####################.........#.......................#
#...#............@...............#...............#########
#...#............#...............#.......................#
#...#............#...............#.........#.............#
#...#............#################.........#.............#
#................#...............#.........#.............#
#................#...............#.........#.............#
#................#......#........#################.......#
##########.......#......#........#............#..........#
#................#......#..#######............#..........#
#................#......#........#......#.....#..........#
#.......##########......#...............#.....#..........#
#................#......#...............#.....#..........#
#................#......................#.....#..........#
#................#......................#................#
##########################################################
35
