.................................................................................
.                                                                               .
.                                                                               .
.                                                                               .
.                                                                               .
.                                                                               .
.                                                                               .
.                                                                               .
.                                                     .                         .
.                                                                               .
.                                                                               .
.                                                                               .
.                                                                               .
.                                                                               .
.                                                                               .
.                                                                               .
.                                                                               .
.                                                                               .
.                                                                               .
.                                                                               .
.                                                                               .
.                                                                               .
.................................................................................
