#############
#       #   #
# ### ### # #
#  #      # #
## # # #### #
#    #      #
# #### ### ##
# #         #
#   #########
#############
