#############
#.......#...#
#.###.###.#.#
#..#@.....#.#
##.#.#.####.#
#....#......#
#.####.###.##
#.#..x......#
#...#########
#####
