#############
#.......#...#
#.###.###.#.#
#..#@.....#.#
##.#.#.####.#
#....#......#
#.####.###.##
#.#..x.....@#
#...#########
#############
