#############
#.......#...#
#.###.###.#.#
#..#......#.#
##.#.#.####.#
#....#......#
#.####.###.##
#.#.........#
#...#########
#############
